****************************************************************************************************
*                                      **                                          **         *    *
*                                      **                                        *****   ***  *    *
*                                      **                                     *****     ****  *    *
*                                      **                                   *****    ******   *    *
*                                      **                                ******   *******     *    *
*            ******                                                                 **        *    *
*                *******         *****                                              **      ***    *
*             ********            ********                                                  **     *
*                ******             ******                                                  **     *
*                  ***                **                                            **      **     *
*                                     **                                              **    **     *
*                                   ****   *                                           ******      *
*                                          *                  ***                                  *
*                                          *                 ****    **                 ************
*                                          *    *        *****     ****                            *
*                           *****              ***     ****************                            *
*                          *************     *****       ******                                    *
*                                 ********    ****                                                 *
*                                    *****   **       **                                           *
*                             *************       ***********                                      *
*                                 ***********   **********               *****                     *
*                                                 ************           ******                    *
*               *****                                                     ****    *******          *
*                *****                                                             ******          *
*              *******              ******                                         ******          *
*                               ***********                                                        *
*              *             *************                                             *****       *
*              *                                          **                                       *
*              *                                          **                                       *
*              *                                        ****                               *       *
*              *                                          ****                         *****       *
*      ******************************                 ********                         ***         *
*                                                        ********                       *          *
*                                                        ** *******                     *          *
*****************                                         **  ****                      *          *
*                                                        **    **                       *          *
*         *******************                             **                            **         *
*                                                          **                           *          *
****************************************************************************************************
